0 0 0 0 0 0 0 0 0 1 0 0 0 0 1 0 0 0 0 1
1 1 1 1 1 1 1 0 0 1 0 0 0 0 1 0 0 0 0 1
10 10 10 10 11 10 10 10 10 11 10 10 10 10 1 0 0 0 0 1
20 20 20 20 21 20 20 20 20 21 20 20 20 20 1 0 0 0 0 1
32 40 40 40 41 40 40 42 40 41 40 40 40 40 1 0 0 0 0 1
0 0 0 0 1 0 0 0 0 1 0 0 0 0 1 0 0 0 0 1
0 0 0 0 1 0 0 0 0 1 0 0 0 0 1 0 0 0 0 1
0 0 0 0 1 0 0 2 0 1 0 0 0 0 1 0 0 0 0 1
