0 1 0 0 31 0 0 0 0 1 0 0 0 0 1 0 0 0 0 1
0 1 0 0 1 0 0 0 0 1 0 0 0 0 1 0 0 0 0 1
0 1 0 0 1 0 0 0 0 1 0 0 0 0 1 0 0 0 0 1
0 1 0 0 1 0 40 0 0 1 0 0 0 0 1 0 0 0 0 1
2 1 0 0 1 0 0 2 0 1 0 0 0 0 1 0 0 0 0 1
0 1 0 0 1 0 0 0 0 1 0 0 0 0 1 0 0 0 0 1
0 1 0 0 1 0 0 0 0 1 0 0 0 0 1 0 0 0 0 1
0 1 0 0 1 0 0 2 0 1 0 0 0 0 1 0 0 0 0 1
