0 0 0 0 0 0 0 0 0 1 0 0 0 0 1 0 0 0 0 1
1 1 1 1 1 1 1 0 0 1 0 0 0 0 1 0 0 0 0 1
11 11 11 11 11 11 11 11 11 11 11 11 11 11 1 0 0 0 0 1
21 21 21 21 21 21 21 21 21 21 21 21 21 21 1 0 0 0 0 1
32 40 40 40 41 40 40 42 40 41 40 40 40 40 1 0 0 0 0 1
0 0 0 0 1 0 0 0 0 1 0 0 0 0 1 0 0 0 0 1
0 0 0 0 1 0 0 0 0 1 0 0 0 0 1 0 0 0 0 1
0 0 0 0 1 0 0 2 0 1 0 0 0 0 1 0 0 0 0 1
